1S111111,10111011,10000111,11110011,11111001,111111E1

11E111,110011,100001,110111,111101,100001,101111,101111,100011,111011,1S1011,111111

1E11111111,1011121001,1011111101,1000000101,111111S111

1E111111,10011011,11011111,11000111,11110111,11110S11

1S1E1,10101,10101,10001,11111

111111,S01111,100111,110001,11110E,111111